NO ./textures/bricks-blue-00.xpm
SO ./textures/bricks-blue-00.xpm
WE ./textures/bricks-blue-00.xpm
EA ./textures/bricks-blue-00.xpm

F 00000000000000000220,00000000000000000100,000000000000000000
C 00000000000000000225,0000000000000000030,00000000000000000

11111
10001
10N01
10001
11111
