
NO ./textures/bricks-blue-00.xpm
SO ./textures/bricks-blue-00.xpm
WE ./textures/bricks-blue-00.xpm
EA ./textures/bricks-blue-00.xpm

F 255,100,0
C 225,30,0


1

1000000000110000000000001
1011000001110000000000001
10010000000000000000000011111111
111111111011000001110000000000001
100000000011000001110111111111111
11110111111111011100000010001
11110111111111011101010010001
11000000110101011100000010001
10000000000000001100000010001
10000000000000001101010010001
11000001110101011111000000S0111
11110111 1110101 101111010001
11111111 1111111 111111111111
11111111111111111111111111111
10000000001100000000000010001
10110000011100000000000010001
10010000000000000000000011111111
111111111011000001110000000000001
100000000011000001110111111111111
11110111111111011100000010001
11110111111111011101010010001
11000000110101011100000010001
10000000000000001100000010001
10000000000000001101010010001
1100000111010101111100000000111
11110111 1110101 101111010001
11111111 1111111 111111111111



