NO ./textures/colorstone.xpm
SO ./textures/greystone.xpm
WE ./textures/bluestone.xpm
EA ./textures/wood.xpm

F 200,40,20
C 50,100,255


        1111111111111111111111111
        1000000000100000000000001
        1011000001110000000000001
        1001000000000000000000001
111111111011000001110000000000001
10000000000011000001110111111111111
11110111111111011100000010001
11110111111111011101010010001
110000001101010111001 1010001
1000000000000001100010010001
1000E000000000001101010000001
1100000111010101111101111000111
11110111 1110101 10111101000011
11111111 1111111 111111111111