NO 1 ./textures/bricks-blue-00.xpm
SO 1 ./textures/bricks-blue-00.xpm
WE 1 ./textures/bricks-blue-00.xpm
EA 1 ./textures/bricks-blue-00.xpm
MP 1 0,0,255

NO 2 ./textures/metal-gray-00.xpm
SO 2 ./textures/metal-gray-00.xpm
WE 2 ./textures/metal-gray-00.xpm
EA 2 ./textures/metal-gray-00.xpm
MP 2 200,200,200

NO 3 ./textures/bricks-gray-00.xpm
SO 3 ./textures/bricks-gray-00.xpm
WE 3 ./textures/bricks-gray-00.xpm
EA 3 ./textures/bricks-gray-00.xpm
MP 3 128,128,128

NO 4 ./textures/metal-green-00.xpm
SO 4 ./textures/metal-green-00.xpm
WE 4 ./textures/metal-green-00.xpm
EA 4 ./textures/metal-green-00.xpm
MP 4 0,255,0

NO X ./textures/door/4.xpm
SO X ./textures/door/4.xpm
WE X ./textures/door/4.xpm
EA X ./textures/door/4.xpm
MP X 255,0,255

MP O 0,255,255


F 159,115,85
C 201,173,142


111111111111111111111111111111
10000000000X000001100000000001
10000000000X000001100000000001
10000111111110000111XX11100001
104401111111100001100001100001
104401100000000001104401100001
100001100000000001100001100001
111111100003300001111111100001
111111100003300001111111100001
100000000003300000000000000001
100000000003300000000000000001
111111100003300001111111111111
111111100003300001111111111111
100001100003300000000000000001
104401100003300000000000000001
100001100003300002222222200001
11XX11100003300002222222200001
100N00000000000000000000000001
100000000000000000000000000001
111111111111111111111111111111