NO ./textures/bricks-blue-00.xpm
SO ./textures/bricks-blue-00.xpm
WE ./textures/bricks-blue-00.xpm
EA ./textures/bricks-blue-00.xpm

F 220,4294967297,0
C 225,30,0

11111
10001
10N01
10001
11111
