NO ./textures/bricks-blue-00.xpm
SO ./textures/bricks-blue-00.xpm
WE ./textures/bricks-blue-00.xpm
EA ./textures/bricks-blue-00.xpm

F 220,100,0
C 225,30,0

111111
 1E001
 11101
 01101
 11111
